;	ー
:	ん
g	、
G	・
n	。
N	？
~/	／
~''	〃
\	〜
|	—
=	：
+	…
[	「
]	」
~[	〈
~{	《
{	『
}	』
~]	〉
~}	》
(	（
~(	【
)	）
~)	】
~'l	‘
~'r	’
~"l	“
~"r	”
!	！
*	※
~h	←
~r	↓
~t	↑
~s	→
~1t	〒
`a	ヶ
~`a	ヵ
t	あ
s	い
l	う
r	え
m	お
h	や
v	ゆ
k	いぇ
c	よ
f	わ
x	ゐ
q	ゑ
d	を
T	あん
S	いん
L	うん
R	えん
M	おん
H	やん
V	ゆん
K	いぇん
C	よん
F	わん
X	ゐん
Q	ゑん
D	をん
``	っ
`t	ぁ
`s	ぃ
`l	ぅ
`r	ぇ
`m	ぉ
`h	ゃ
`v	ゅ
`k	ぇ
`c	ょ
`f	ゎ
`x	うぃ
`q	うぇ
`d	うぉ
`T	ぁん
`S	ぃん
`L	ぅん
`R	ぇん
`M	ぉん
`H	ゃん
`V	ゅん
`K	ぇん
`C	ょん
`F	ゎん
`X	うぃん
`Q	うぇん
`D	うぉん
aa	っ	a
A	っ	a
at	か
as	き
al	く
ar	け
am	こ
ah	きゃ
av	きゅ
ak	きぇ
ac	きょ
af	くぁ
ax	くぃ
aq	くぇ
ad	くぉ
aT	かん
aS	きん
aL	くん
aR	けん
aM	こん
aH	きゃん
aV	きゅん
aK	きぇん
aC	きょん
aF	くぁん
aX	くぃん
aQ	くぇん
aD	くぉん
,,	っ	,
<	っ	,
,t	が
,s	ぎ
,l	ぐ
,r	げ
,m	ご
,h	ぎゃ
,v	ぎゅ
,k	ぎぇ
,c	ぎょ
,f	ぐぁ
,x	ぐぃ
,q	ぐぇ
,d	ぐぉ
,T	がん
,S	ぎん
,L	ぐん
,R	げん
,M	ごん
,H	ぎゃん
,V	ぎゅん
,K	ぎぇん
,C	ぎょん
,F	ぐぁん
,X	ぐぃん
,Q	ぐぇん
,D	ぐぉん
ee	っ	e
E	っ	e
et	さ
es	し
el	す
er	せ
em	そ
eh	しゃ
ev	しゅ
ek	しぇ
ec	しょ
ef	すぁ
ex	すぃ
eq	すぇ
ed	すぉ
eT	さん
eS	しん
eL	すん
eR	せん
eM	そん
eH	しゃん
eV	しゅん
eK	しぇん
eC	しょん
eF	すぁん
eX	すぃん
eQ	すぇん
eD	すぉん
..	っ	.
>	っ	.
.t	ざ
.s	じ
.l	ず
.r	ぜ
.m	ぞ
.h	じゃ
.v	じゅ
.k	じぇ
.c	じょ
.f	ずぁ
.x	ずぃ
.q	ずぇ
.d	すぉ
.T	ざん
.S	じん
.L	ずん
.R	ぜん
.M	ぞん
.H	じゃん
.V	じゅん
.K	じぇん
.C	じょん
.F	ずぁん
.X	ずぃん
.Q	ずぇん
.D	すぉん
ii	っ	i
I	っ	i
it	た
is	ち
il	つ
ir	て
im	と
ih	ちゃ
iv	ちゅ
ik	ちぇ
ic	ちょ
if	つぁ
ix	つぃ
iq	つぇ
id	つぉ
iT	たん
iS	ちん
iL	つん
iR	てん
iM	とん
iH	ちゃん
iV	ちゅん
iK	ちぇん
iC	ちょん
iF	つぁん
iX	つぃん
iQ	つぇん
iD	つぉん
bb	っ	b
B	っ	b
bt	だ
bs	ぢ
bl	づ
br	で
bm	ど
bh	ぢゃ
bv	ぢゅ
bk	ぢぇ
bc	ぢょ
bf	づぁ
bx	づぃ
bq	づぇ
bd	づぉ
bT	だん
bS	ぢん
bL	づん
bR	でん
bM	どん
bH	ぢゃん
bV	ぢゅん
bK	ぢぇん
bC	ぢょん
bF	づぁん
bX	づぃん
bQ	づぇん
bD	づぉん
uu	っ	u
U	っ	u
ut	な
us	に
ul	ぬ
ur	ね
um	の
uh	にゃ
uv	にゅ
uk	にぇ
uc	にょ
uf	ぬぁ
ux	ぬぃ
uq	ぬぇ
ud	ぬぉ
uT	なん
uS	にん
uL	ぬん
uR	ねん
uM	のん
uH	にゃん
uV	にゅん
uK	にぇん
uC	にょん
uF	ぬぁん
uX	ぬぃん
uQ	ぬぇん
uD	ぬぉん
yy	っ	y
Y	っ	y
yt	は
ys	ひ
yl	ふ
yr	へ
ym	ほ
yh	ひゃ
yv	ひゅ
yk	ひぇ
yc	ひょ
yf	ふぁ
yx	ふぃ
yq	ふぇ
yd	ふぉ
yT	はん
yS	ひん
yL	ふん
yR	へん
yM	ほん
yH	ひゃん
yV	ひゅん
yK	ひぇん
yC	ひょん
yF	ふぁん
yX	ふぃん
yQ	ふぇん
yD	ふぉん
--	っ	-
_	っ	-
-t	ば
-s	び
-l	ぶ
-r	べ
-m	ぼ
-h	びゃ
-v	びゅ
-k	びぇ
-c	びょ
-f	ぶぁ
-x	ぶぃ
-q	ぶぇ
-d	ぶぉ
-T	ばん
-S	びん
-L	ぶん
-R	べん
-M	ぼん
-H	びゃん
-V	びゅん
-K	びぇん
-C	びょん
-F	ぶぁん
-X	ぶぃん
-Q	ぶぇん
-D	ぶぉん
jj	っ	j
?	っ	j
jt	ぱ
js	ぴ
jl	ぷ
jr	ぺ
jm	ぽ
jh	ぴゃ
jv	ぴゅ
jk	ぴぇ
jc	ぴょ
jf	ぷぁ
jx	ぷぃ
jq	ぷぇ
jd	ぷぉ
jT	ぱん
jS	ぴん
jL	ぷん
jR	ぺん
jM	ぽん
jH	ぴゃん
jV	ぴゅん
jK	ぴぇん
jC	ぴょん
jF	ぷぁん
jX	ぷぃん
jQ	ぷぇん
jD	ぷぉん
oo	っ	o
O	っ	o
ot	ま
os	み
ol	む
or	め
om	も
oh	みゃ
ov	みゅ
ok	みぇ
oc	みょ
of	むぁ
ox	むぃ
oq	むぇ
od	むぉ
oT	まん
oS	みん
oL	むん
oR	めん
oM	もん
oH	みゃん
oV	みゅん
oK	みぇん
oC	みょん
oF	むぁん
oX	むぃん
oQ	むぇん
oD	むぉん
pp	っ	p
P	っ	p
pt	ら
ps	り
pl	る
pr	れ
pm	ろ
ph	りゃ
pv	りゅ
pk	りぇ
pc	りょ
pf	るぁ
px	るぃ
pq	るぇ
pd	るぉ
pT	らん
pS	りん
pL	るん
pR	れん
pM	ろん
pH	りゃん
pV	りゅん
pK	りぇん
pC	りょん
pF	るぁん
pX	るぃん
pQ	るぇん
pD	るぉん
ww	っ	w
W	っ	w
wt	た
ws	てぃ
wl	とぅ
wr	て
wm	と
wh	てゃ
wv	てゅ
wk	てぇ
wc	てょ
wf	とぁ
wx	とぃ
wq	とぇ
wd	とぉ
wT	たん
wS	てぃん
wL	とぅん
wR	てん
wM	とん
wH	てゃん
wV	てゅん
wK	てぇん
wC	てょん
wF	とぁん
wX	とぃん
wQ	とぇん
wD	とぉん
//	っ	/
?	っ	/
/t	だ
/s	でぃ
/l	どぅ
/r	で
/m	ど
/h	でゃ
/v	でゅ
/k	でぇ
/c	でょ
/f	どぁ
/x	どぃ
/q	どぇ
/d	どぉ
/T	だん
/S	でぃん
/L	どぅん
/R	でん
/M	どん
/H	でゃん
/V	でゅん
/K	でぇん
/C	でょん
/F	どぁん
/X	どぃん
/Q	どぇん
/D	どぉん
''	っ	'
"	っ	'
't	ふぁ
's	ふぃ
'l	ふ
'r	ふぇ
'm	ふぉ
'h	ふゃ
'v	ふゅ
'k	ふぇ
'c	ふょ
'f	ほぁ
'x	ほぃ
'q	ほぇ
'd	ほぉ
'T	ふぁん
'S	ふぃん
'L	ふん
'R	ふぇん
'M	ふぉん
'H	ふゃん
'V	ふゅん
'K	ふぇん
'C	ふょん
'F	ほぁん
'X	ほぃん
'Q	ほぇん
'D	ほぉん
zz	っ	z
Z	っ	z
zt	ゔぁ
zs	ゔぃ
zl	ゔ
zr	ゔぇ
zm	ゔぉ
zh	ゔゃ
zv	ゔゅ
zk	ゔぇ
zc	ゔょ
zf	ぼぁ
zx	ぼぃ
zq	ぼぇ
zd	ぼぉ
zT	ゔぁん
zS	ゔぃん
zL	ゔん
zR	ゔぇん
zM	ゔぉん
zH	ゔゃん
zV	ゔゅん
zC	ゔょん
zF	ぼぁん
zX	ぼぃん
zQ	ぼぇん
zD	ぼぉん
