n	、
g	。
N	・
G	？
[	「
]	」
{	『
}	』
`	〜
;	：
~	—
:	…
!	！
(	（
)	）
*	※
&	＆
Lh	←
Lr	↓
Lt	↑
Ls	→
Lm	〃
Ln	／
L\	ヵ
q	あ
t	い
r	う
Y	え
k	お
a	か
c	き
m	く
O	け
,	こ
x	さ
i	し
-	す
A	せ
E	そ
.	た
'	ち
v	つ
u	て
e	と
p	な
o	に
+	ぬ
W	ね
s	の
w	は
S	ひ
M	ふ
B	へ
C	ほ
d	ま
T	み
J	む
D	め
b	も
<	や
_	ゆ
>	よ
=	ら
z	り
j	る
I	れ
P	ろ
U	わ
"	ゐ
V	ゑ
/	を
h	ん
f	っ
F	ー
H	ゃ
R	ゅ
y	ょ
Q	ぁ
X	ぃ
?	ぅ
K	ぇ
Z	ぉ
|	ゎ
\	ヶ
la	が
lc	ぎ
lm	ぐ
lO	げ
l,	ご
lx	ざ
li	じ
l-	ず
lA	ぜ
lE	ぞ
l.	だ
l'	ぢ
lv	づ
lu	で
le	ど
lw	ば
lS	び
lM	ぶ
lB	べ
lC	ぼ
Lw	ぱ
LS	ぴ
LM	ぷ
LB	ぺ
LC	ぽ
lr	ゔ
